000P_000P_000P_000P_000P_000P_
000P_111Pthree_010oneø_000P_000P_000P_
000P_000Ptwo_111hiL_000there_000P_000P_
000P_000P_100four_110P_000Pfive_000P_
000P_000P_000P_000six˜_000P_000P_
000P_000P_000P_000P_000P_000P_

000P_000P_000P_000P_000P_000P_
000P_100P_010_000P_000P_000P_
000P_000P_101_000_000P_000P_
000P_000P_000P_000P_000P_000P_
000P_000P_000P_000P_000P_000P_
000P_000P_000P_000P_000P_000P_

000P_000P_000P_000P_000P_000P_
000P_000P_000P_000P_000P_000P_
000P_000P_000P_000P_000P_000P_
000P_000P_000P_000P_000P_000P_
000P_000P_000P_000P_000P_000P_
000P_000P_000P_000P_000P_000P_

000P_000P_000P_000P_000P_000P_
000P_000P_000P_000P_000P_000P_
000P_000P_000P_000P_000P_000P_
000P_000P_000P_000P_000P_000P_
000P_000P_000P_000P_000P_000P_
000P_000P_000P_000P_000P_000P_

000P_000P_000P_000P_000P_000P_
000P_000P_000P_000P_000P_000P_
000P_000P_000P_000P_000P_000P_
000P_000P_000P_000P_000P_000P_
000P_000P_000P_000P_000P_000P_
000P_000P_000P_000P_000P_000P_

000P_000P_000P_000P_000P_000P_
000P_000P_000P_000P_000P_000P_
000P_000P_000P_000P_000P_000P_
000P_000P_000P_000P_000P_000P_
000P_000P_000P_000P_000P_000P_
000P_000P_000P_000P_000P_000P_
